type octile
height 31
width 79
map
0000000000000000000000000000000000000000000000000000000000000000000000000000000
0000011111101111110111111011111101111110111111011111101111110111111011111100000
0000011111101111110111111011111101111110111111011111101111110111111011111100000
0000000000000000000000000000000000000000000000000000000000000000000000000000000
0000011111101111110111111011111101111110111111011111101111110111111011111100000
0000011111101111110111111011111101111110111111011111101111110111111011111100000
0000000000000000000000000000000000000000000000000000000000000000000000000000000
0000011111101111110111111011111101111110111111011111101111110111111011111100000
0000011111101111110111111011111101111110111111011111101111110111111011111100000
0000000000000000000000000000000000000000000000000000000000000000000000000000000
0000011111101111110111111011111101111110111111011111101111110111111011111100000
0000011111101111110111111011111101111110111111011111101111110111111011111100000
0000000000000000000000000000000000000000000000000000000000000000000000000000000
0000011111101111110111111011111101111110111111011111101111110111111011111100000
0000011111101111110111111011111101111110111111011111101111110111111011111100000
0000000000000000000000000000000000000000000000000000000000000000000000000000000
0000011111101111110111111011111101111110111111011111101111110111111011111100000
0000011111101111110111111011111101111110111111011111101111110111111011111100000
0000000000000000000000000000000000000000000000000000000000000000000000000000000
0000011111101111110111111011111101111110111111011111101111110111111011111100000
0000011111101111110111111011111101111110111111011111101111110111111011111100000
0000000000000000000000000000000000000000000000000000000000000000000000000000000
0000011111101111110111111011111101111110111111011111101111110111111011111100000
0000011111101111110111111011111101111110111111011111101111110111111011111100000
0000000000000000000000000000000000000000000000000000000000000000000000000000000
0000011111101111110111111011111101111110111111011111101111110111111011111100000
0000011111101111110111111011111101111110111111011111101111110111111011111100000
0000000000000000000000000000000000000000000000000000000000000000000000000000000
0000011111101111110111111011111101111110111111011111101111110111111011111100000
0000011111101111110111111011111101111110111111011111101111110111111011111100000
0000000000000000000000000000000000000000000000000000000000000000000000000000000
